111111111111111
1E1C0000C0000C1
101000C0000P001
1C00X1111111111
101111C00000001
1000X1111111101
1001000000000C1
111111111111111